##########
#........#
#........#
#........#
#....#...#
#........#
#........#
#........#
#........#
##########

