##########
#........#
#..##....#
#........#
#..##..###
#........#
#..##....#
#........#
##########

